*********************
*         *         *
*         *         *
*         *         *
*         *         *
*         *         *
*         *         *
*         *         *
*                   *
*                   *
*                   *
*                   *
*              **   *
*              **   *
*              *    *
*                   *
*                   *
*********************